Abashiri	網走市
Abiko	我孫子市
Abira	安平町
Abu	阿武町
Adachi	足立区
Aga	阿賀町
Agano	阿賀野市
Agematsu	上松町
Ageo	上尾市
Agui	阿久比町
Aibetsu	愛別町
Aikawa	愛川町
Ainan	愛南町
Aioi	相生市
Aira	姶良市
Aisai	愛西市
Aishō	愛荘町
Aizubange	会津坂下町
Aizumi	藍住町
Aizumisato	会津美里町
Aizuwakamatsu	会津若松市
Ajigasawa	鰺ヶ沢町
Akabira	赤平市
Akaiwa	赤磐市
Akashi	明石市
Aki	安芸市
Akigawa	秋川市
Akiōta	安芸太田町
Akiruno	あきる野市
Akishima	昭島市
Akita	秋田市
Akita	秋田
Akitakata	安芸高田市
Akkeshi	厚岸町
Akō	赤穂市
Akune	阿久根市
Ama	あま市
Ama	海士町
Amagasaki	尼崎市
Amagi	天城町
Amagi	甘木市
Amakusa	天草市
Amami	奄美市
Ami	阿見町
Anamizu	穴水町
Anan	阿南市
Anan	阿南町
Ando	安堵町
Anjō	安城市
Annaka	安中市
Anpachi	安八町
Aomori	青森市
Aomori	青森
Arakawa	荒川区
Arao	荒尾市
Arida	有田市
Aridagawa	有田川町
Arita	有田町
Asagiri	あさぎり町
Asago	朝来市
Asahi	旭市
Asahi	朝日町
Asahikawa	旭川市
Asahikawa	旭川
Asaka	朝霞市
Asakawa	浅川町
Asakuchi	浅口市
Asakura	朝倉市
Ashibetsu	芦別市
Ashibetsu	芦別
Ashikaga	足利市
Ashikaga	足利
Ashikita	芦北町
Ashiya	芦屋市
Ashiya	芦屋
Ashiya	芦屋町
Ashoro	足寄町
Aso	阿蘇市
Assabu	厚沢部町
Atami	熱海市
Atami	熱海
Atsugi	厚木市
Atsugi	厚木
Atsuma	厚真町
Awa	阿波市
Awaji	淡路市
Awara	あわら市
Aya	綾町
Ayabe	綾部市
Ayagawa	綾川町
Ayase	綾瀬市
Azumino	安曇野市
Bandai	磐梯町
Bandō	坂東市
Beppu	別府市
Beppu	別府
Betsukai	別海町
Bibai	美唄市
Biei	美瑛町
Bifuka	美深町
Bihoro	美幌町
Biratori	平取町
Bisai	尾西市
Bizen	備前市
Bungo-ōno	豊後大野市
Bungotakada	豊後高田市
Bunkyō	文京区
Buzen	豊前市
Chatan	北谷町
Chiba	千葉市
Chiba	千葉
Chichibu	秩父市
Chigasaki	茅ヶ崎市
Chigasaki	茅ヶ崎
Chikugo	筑後市
Chikujō	築上町
Chikuma	千曲市
Chikusei	筑西市
Chikushino	筑紫野市
Chikuzen	筑前町
China	知名町
Chino	茅野市
Chippubetsu	秩父別町
Chiryū	知立市
Chita	知多市
Chitose	千歳市
Chitose	千歳
Chiyoda	千代田区
Chiyoda	千代田町
Chizu	智頭町
Chofu	調布
Chōfu	調布市
Chōnan	長南町
Chōshi	銚子市
Chūō	中央区
Chūō	中央市
Daigo	大子町
Daisen	大仙市
Daisen	大山町
Daito	大刀
Daitō	大東市
Date	伊達市
Dazaifu	太宰府市
Ebetsu	江別市
Ebina	海老名市
Ebino	えびの市
Echizen	越前市
Echizen	越前町
Edogawa	江戸川区
Eiheiji	永平寺町
Ena	恵那市
Enbetsu	遠別町
Engaru	遠軽町
Eniwa	恵庭市
Erimo	えりも町
Esashi	江差町
Esashi	枝幸町
Esashi	江刺市
Etajima	江田島市
Fuchu	府中
Fuchū	府中市
Fuchū	府中町
Fuefuki	笛吹市
Fuji	富士市
Fuji	富士
Fujieda	藤枝市
Fujiidera	藤井寺市
Fujikawa	富士川町
Fujikawaguchiko	富士河口湖町
Fujimi	富士見市
Fujimi	富士見町
Fujimino	ふじみ野市
Fujinomiya	富士宮市
Fujioka	藤岡市
Fujioka	藤岡
Fujisaki	藤崎町
Fujisato	藤里町
Fujisawa	藤沢市
Fujisawa	藤沢
Fujiyoshida	富士吉田市
Fukagawa	深川市
Fukaura	深浦町
Fukaya	深谷市
Fukuchi	福智町
Fukuchiyama	福知山市
Fukuchiyama	福知山
Fukui	福井市
Fukui	福井
Fukuoka	福岡市
Fukuoka	福岡
Fukuroi	袋井市
Fukusaki	福崎町
Fukushima	福島市
Fukushima	福島
Fukushima	福島町
Fukutsu	福津市
Fukuyama	福山市
Fukuyama	福山
Funabashi	船橋市
Funabashi	船橋
Funagata	舟形町
Furano	富良野市
Furano	富良野
Furubira	古平町
Furudono	古殿町
Fusō	扶桑町
Fussa	福生市
Futaba	双葉町
Futtsu	富津市
Gamagōri	蒲郡市
Genkai	玄海町
Gero	下呂市
Gifu	岐阜市
Gifu	岐阜
Ginan	岐南町
Ginowan	宜野湾市
Ginowan	宜野湾
Gobō	御坊市
Gōdo	神戸町
Gojō	五條市
Gojōme	五城目町
Goka	五霞町
Gokase	五ヶ瀬町
Gonohe	五戸町
Gose	御所市
Gosen	五泉市
Goshogawara	五所川原市
Goshogawara	五所川原
Gotenba	御殿場市
Gotō	五島市
Gōtsu	江津市
Gujō	郡上市
Gushikawa	具志川
Gyōda	行田市
Gyokutō	玉東町
Habikino	羽曳野市
Haboro	羽幌町
Hachijō	八丈町
Hachimantai	八幡平市
Hachinohe	八戸市
Hachinohe	八戸
Hachioji	八王子
Hachiōji	八王子市
Hachirōgata	八郎潟町
Hadano	秦野市
Haebaru	南風原町
Haga	芳賀町
Hagi	萩市
Hakodate	函館市
Hakodate	函館
Hakone	箱根
Hakone	箱根町
Hakuba	白馬
Hakui	羽咋市
Hakusan	白山市
Hamada	浜田市
Hamamatsu	浜松市
Hamamatsu	浜松
Hamanaka	浜中町
Hamatonbetsu	浜頓別町
Hamura	羽村市
Hanamaki	花巻市
Hanawa	塙町
Handa	半田市
Hannan	阪南市
Hannō	飯能市
Hanyū	羽生市
Happō	八峰町
Haramachi	原町市
Harima	播磨町
Hasami	波佐見町
Hashikami	階上町
Hashima	羽島市
Hashimoto	橋本市
Hasuda	蓮田市
Hatoyama	鳩山町
Hatsukaichi	廿日市市
Hayakawa	早川町
Hayama	葉山町
Hayashima	早島町
Heguri	平群町
Hekinan	碧南市
Hichisō	七宗町
Hida	飛騨市
Hidaka	日高市
Hidaka	日高町
Hidakagawa	日高川町
Higashiagatsuma	東吾妻町
Higashihiroshima	東広島市
Higashiizu	東伊豆町
Higashikagawa	東かがわ市
Higashikagura	東神楽町
Higashikawa	東川町
Higashikurume	東久留米市
Higashikushira	東串良町
Higashimatsushima	東松島市
Higashimatsuyama	東松山市
Higashimiyoshi	東みよし町
Higashimurayama	東村山市
Higashine	東根市
Higashiōmi	東近江市
Higashiōsaka	東大阪市
Higashisonogi	東彼杵町
Higashiura	東浦町
Higashiyamato	東大和市
Hiji	日出町
Hikari	光市
Hikawa	氷川町
Hikone	彦根市
Hikone	彦根
Himeji	姫路市
Himeji	姫路
Himi	氷見市
Hino	日野市
Hino	日野
Hino	日野町
Hinode	日の出町
Hinokage	日之影町
Hioki	日置市
Hirado	平戸市
Hiraizumi	平泉町
Hirakata	枚方市
Hirakawa	平川市
Hiranai	平内町
Hirao	平生町
Hiratsuka	平塚市
Hiratsuka	平塚
Hirogawa	広川町
Hirokawa	広川町
Hirono	洋野町
Hirono	広野町
Hiroo	広尾町
Hirosaki	弘前市
Hirosaki	弘前
Hiroshima	広島市
Hiroshima	広島
Hisayama	久山町
Hita	日田市
Hitachi	日立市
Hitachinaka	ひたちなか市
Hitachiōmiya	常陸大宮市
Hitachiōta	常陸太田市
Hitoyoshi	人吉市
Hōdatsushimizu	宝達志水町
Hōfu	防府市
Hōjō	北条市
Hōki	伯耆町
Hokota	鉾田市
Hokuei	北栄町
Hokuryū	北竜町
Hokuto	北斗市
Hokuto	北杜市
Honbetsu	本別町
Honjō	本庄市
Honjō	本荘市
Horokanai	幌加内町
Horonobe	幌延町
Hōya	保谷市
Hyūga	日向市
Ibara	井原市
Ibaraki	茨木市
Ibaraki	茨城
Ibaraki	茨城町
Ibigawa	揖斐川町
Ibusuki	指宿市
Ibusuki	指宿
Ichihara	市原市
Ichihara	市原
Ichikai	市貝町
Ichikawa	市川市
Ichikawa	市川
Ichikawa	市川町
Ichikawamisato	市川三郷町
Ichikikushikino	いちき串木野市
Ichinohe	一戸町
Ichinomiya	一宮市
Ichinomiya	一宮
Ichinomiya	一宮町
Ichinoseki	一関市
Ide	井手町
Iga	伊賀市
Iida	飯田市
Iide	飯豊町
Iijima	飯島町
Iinan	飯南町
Iiyama	飯山市
Iizuka	飯塚市
Iizuna	飯綱町
Ikaruga	斑鳩町
Ikata	伊方町
Ikawa	井川町
Ikeda	池田市
Ikeda	池田
Ikeda	池田町
Iki	壱岐市
Ikoma	生駒市
Ikoma	生駒
Imabari	今治市
Imabari	今治
Imabetsu	今別町
Imakane	今金町
Imari	伊万里市
Imari	万里
Imizu	射水市
Ina	伊那市
Ina	伊奈町
Inabe	いなべ市
Inagawa	猪名川町
Inagi	稲城市
Inami	稲美町
Inami	印南町
Inashiki	稲敷市
Inawashiro	猪苗代町
Inazawa	稲沢市
Ine	伊根町
Innoshima	原町市
Ino	いの町
Inuyama	犬山市
Inzai	印西市
Iruma	入間市
Isa	伊佐市
Isahaya	諫早市
Ise	伊勢市
Ise	伊勢
Isehara	伊勢原市
Isen	伊仙町
Isesaki	伊勢崎市
Ishigaki	石垣市
Ishii	石井町
Ishikari	石狩市
Ishikawa	石川町
Ishinomaki	石巻市
Ishioka	石岡市
Isumi	いすみ市
Itabashi	板橋区
Itako	潮来市
Itakura	板倉町
Itami	伊丹市
Itami	伊丹
Itano	板野町
Itayanagi	板柳町
Itō	伊東市
Itoda	糸田町
Itoigawa	糸魚川市
Itoman	糸満市
Itoshima	糸島市
Iwade	岩出市
Iwai	岩井市
Iwaizumi	岩泉町
Iwaki	いわき市
Iwaki	磐城市
Iwakuni	岩国市
Iwakura	岩倉市
Iwami	岩美町
Iwamizawa	岩見沢市
Iwanai	岩内町
Iwanuma	岩沼市
Iwata	磐田市
Iwate	岩手町
Iyo	伊予市
Iyomishima	伊予三島市
Izu	伊豆市
Izumi	出水市
Izumi	和泉市
Izumiōtsu	泉大津市
Izumisano	泉佐野市
Izumo	出雲市
Izumo	出雲
Izumozaki	出雲崎町
Izunokuni	伊豆の国市
Jinsekikōgen	神石高原町
Jōban	常磐市
Jōetsu	上越市
Jōsō	常総市
Jōyō	城陽市
Kadena	嘉手納町
Kadogawa	門川町
Kadoma	門真市
Kaga	加賀市
Kagamiishi	鏡石町
Kagamino	鏡野町
Kagoshima	鹿児島市
Kagoshima	鹿児島
Kahoku	かほく市
Kahoku	河北町
Kai	甲斐市
Kainan	海南市
Kaisei	開成町
Kaita	海田町
Kaiyō	海陽町
Kaizu	海津市
Kaizuka	貝塚市
Kakamigahara	各務原市
Kakegawa	掛川市
Kakogawa	加古川市
Kakogawa	加古川
Kakuda	角田市
Kama	嘉麻市
Kamagaya	鎌ヶ谷市
Kamaishi	釜石市
Kamakura	鎌倉市
Kameda	亀田市
Kameoka	亀岡市
Kameyama	亀山市
Kami	香美市
Kami	加美町
Kami	香美町
Kami-Amakusa	上天草市
Kamifurano	上富良野町
Kamigōri	上郡町
Kamiichi	上市町
Kamiita	上板町
Kamijima	上島町
Kamikatsu	上勝町
Kamikawa	上川町
Kamikawa	神川町
Kamikawa	神河町
Kamimine	上峰町
Kaminokawa	上三川町
Kaminokuni	上ノ国町
Kaminoseki	上関町
Kaminoyama	上山市
Kamisato	上里町
Kamishihoro	上士幌町
Kamisu	神栖市
Kamisunagawa	上砂川町
Kamitonda	上富田町
Kamiyama	神山町
Kamo	加茂市
Kamogawa	鴨川市
Kan'onji	観音寺市
Kanan	河南町
Kanazawa	金沢市
Kanazawa	金沢
Kanda	苅田町
Kanegasaki	金ケ崎町
Kaneyama	金山町
Kani	可児市
Kanie	蟹江町
Kanmaki	上牧町
Kanna	神流町
Kannami	函南町
Kanoya	鹿屋市
Kanra	甘楽町
Kanuma	鹿沼市
Kanzaki	神埼市
Karatsu	唐津市
Kariya	刈谷市
Karuizawa	軽井沢
Karuizawa	軽井沢町
Karumai	軽米町
Kasagi	笠置町
Kasai	加西市
Kasama	笠間市
Kasamatsu	笠松町
Kasaoka	笠岡市
Kaseda	加世田市
Kashiba	香芝市
Kashihara	橿原市
Kashima	鹿嶋市
Kashima	鹿島市
Kashima	嘉島町
Kashiwa	柏市
Kashiwara	柏原市
Kashiwazaki	柏崎市
Kasuga	春日市
Kasugai	春日井市
Kasugai	鎹
Kasukabe	春日部市
Kasukabe	春日部
Kasumigaura	かすみがうら市
Kasuya	粕屋町
Katagami	潟上市
Katano	交野市
Katō	加東市
Katori	香取市
Katsuragi	葛城市
Katsuragi	かつらぎ町
Katsushika	葛飾区
Katsuta	勝田市
Katsuura	勝浦市
Katsuura	勝浦町
Katsuyama	勝山市
Kawabe	川辺町
Kawachi	河内町
Kawachinagano	河内長野市
Kawagoe	川越市
Kawagoe	川越
Kawagoe	川越町
Kawaguchi	川口市
Kawaguchi	川口
Kawai	河合町
Kawajima	川島町
Kawakita	川北町
Kawamata	川俣町
Kawaminami	川南町
Kawamoto	川本町
Kawanehon	川根本町
Kawanishi	川西市
Kawanishi	川西町
Kawanoe	川之江市
Kawara	香春町
Kawasaki	川崎市
Kawasaki	川崎
Kawasaki	川崎町
Kawatana	川棚町
Kawazu	河津町
Kazo	加須市
Kazuno	鹿角市
Keisen	桂川町
Kenbuchi	剣淵町
Kesennuma	気仙沼市
Kibichūō	吉備中央町
Kihō	紀宝町
Kihoku	紀北町
Kihoku	鬼北町
Kijō	木城町
Kikai	喜界町
Kikonai	木古内町
Kikuchi	菊池市
Kikugawa	菊川市
Kikuyō	菊陽町
Kimino	紀美野町
Kimitsu	君津市
Kimobetsu	喜茂別町
Kimotsuki	肝付町
Kin	金武町
Kinkō	錦江町
Kinokawa	紀の川市
Kirishima	霧島市
Kirishima	霧島
Kiryu	桐生
Kiryū	桐生市
Kisarazu	木更津市
Kishiwada	岸和田市
Kishiwada	岸和田
Kiso	木曽町
Kisosaki	木曽岬町
Kita	北区
Kita-Kyushu	北九州
Kitaakita	北秋田市
Kitagata	北方町
Kitahiroshima	北広島市
Kitahiroshima	北広島町
Kitaibaraki	北茨城市
Kitajima	北島町
Kitakami	北上市
Kitakata	喜多方市
Kitakyushu	北九州市
Kitami	北見市
Kitamoto	北本市
Kitanagoya	北名古屋市
Kitsuki	杵築市
Kiyama	基山町
Kiyosato	清里町
Kiyose	清瀬市
Kiyosu	清須市
Kizugawa	木津川市
Kobayashi	小林市
Kobe	神戸市
Kobe	神戸
Kochi	高知
Kōchi	高知市
Kodaira	小平市
Kofu	国府
Kōfu	甲府市
Kōfu	江府町
Koga	古賀市
Koga	古河市
Koganei	小金井市
Kōge	上毛町
Kōhoku	江北町
Kōka	甲賀市
Kokonoe	九重町
Kokubu	国分市
Kokubunji	国分寺市
Kokura	小倉市
Komae	狛江市
Komagane	駒ヶ根市
Komaki	小牧市
Komatsu	小松市
Komatsushima	小松島市
Komono	菰野町
Komoro	小諸市
Konan	湖南市
Kōnan	江南市
Kōnan	香南市
Kōnosu	鴻巣市
Koori	桑折町
Kōra	甲良町
Koriyama	郡山
Kōriyama	郡山市
Kōryō	広陵町
Kōsa	甲佐町
Kosai	湖西市
Kosaka	小坂町
Kōshi	合志市
Koshigaya	越谷市
Koshigaya	越谷
Koshimizu	小清水町
Kōshū	甲州市
Kōta	幸田町
Kotake	小竹町
Kōtō	江東区
Kotohira	琴平町
Kotoura	琴浦町
Koumi	小海町
Kōya	高野町
Kozagawa	古座川町
Kōzaki	神崎町
Kudamatsu	下松市
Kudoyama	九度山町
Kuji	久慈市
Kujūkuri	九十九里町
Kuki	久喜市
Kumagaya	熊谷市
Kumagaya	熊谷
Kumakōgen	久万高原町
Kumamoto	熊本市
Kumamoto	熊本
Kumano	熊野市
Kumano	熊野町
Kumatori	熊取町
Kumejima	久米島町
Kumenan	久米南町
Kumiyama	久御山町
Kunimi	国見町
Kunisaki	国東市
Kunitachi	国立市
Kunitomi	国富町
Kunneppu	訓子府町
Kurashiki	倉敷市
Kurashiki	倉敷
Kurate	鞍手町
Kurayoshi	倉吉市
Kure	呉市
Kure	呉
Kurihara	栗原市
Kuriyama	栗山町
Kurobe	黒部市
Kuroishi	黒石市
Kuromatsunai	黒松内町
Kuroshio	黒潮町
Kurume	久留米市
Kurume	久留米
Kusatsu	草津市
Kusatsu	草津
Kusatsu	草津町
Kushikino	串木野市
Kushima	串間市
Kushimoto	串本町
Kushiro	釧路市
Kushiro	釧路
Kushiro	釧路町
Kusu	玖珠町
Kutchan	倶知安町
Kuwana	桑名市
Kuzumaki	葛巻町
Kyōgoku	京極町
Kyonan	鋸南町
Kyōtamba	京丹波町
Kyōtanabe	京田辺市
Kyōtango	京丹後市
Kyoto	京都市
Kyoto	京都
Kyōwa	共和町
Machida	町田市
Machida	町田
Maebaru	前原市
Maebashi	前橋市
Maebashi	前橋
Maibara	米原市
Maizuru	舞鶴市
Makinohara	牧之原市
Makubetsu	幕別町
Makurazaki	枕崎市
Mamurogawa	真室川町
Manazuru	真鶴町
Maniwa	真庭市
Mannō	まんのう町
Marugame	丸亀市
Marumori	丸森町
Masaki	松前町
Mashike	増毛町
Mashiki	益城町
Mashiko	益子町
Masuda	益田市
Matsubara	松原市
Matsubara	松原
Matsubushi	松伏町
Matsuda	松田町
Matsudo	松戸市
Matsue	松江市
Matsue	松江
Matsukawa	松川町
Matsumae	松前町
Matsumoto	松本市
Matsumoto	松本
Matsunaga	松永市
Matsuno	松野町
Matsusaka	松阪市
Matsushige	松茂町
Matsushima	松島町
Matsuura	松浦市
Matsuyama	松山市
Matsuyama	松山
Matsuzaki	松崎町
Mattō	松任市
Meguro	目黒区
Meiwa	明和町
Memanbetsu	女満別
Memuro	芽室町
Mibu	壬生町
Midori	みどり市
Mifune	御船町
Mihama	美浜町
Mihama	御浜町
Mihara	三原市
Miharu	三春町
Mikasa	三笠市
Mikawa	三川町
Miki	三木市
Miki	三木町
Mima	美馬市
Mimasaka	美作市
Mimata	三股町
Minabe	みなべ町
Minakami	みなかみ町
Minamata	水俣市
Minami	美波町
Minami-Alps	南アルプス市
Minami-Uonuma	南魚沼市
Minamiaizu	南会津町
Minamiashigara	南足柄市
Minamiawaji	南あわじ市
Minamibōsō	南房総市
Minamichita	南知多町
Minamiechizen	南越前町
Minamifurano	南富良野町
Minamiise	南伊勢町
Minamiizu	南伊豆町
Minamikyūshū	南九州市
Minamioguni	南小国町
Minamiōsumi	南大隅町
Minamisanriku	南三陸町
Minamisatsuma	南さつま市
Minamishimabara	南島原市
Minamisōma	南相馬市
Minamitane	南種子町
Minano	皆野町
Minato	港区
Mine	美祢市
Mino	美濃市
Minobu	身延町
Minoh	箕面市
Minokamo	美濃加茂市
Minowa	箕輪町
Misaki	岬町
Misaki	美咲町
Misasa	三朝町
Misato	三郷市
Misato	美里町
Misato	美郷町
Misawa	三沢市
Mishima	三島市
Mishima	三島町
Mitaka	三鷹市
Mitaka	三鷹
Mitake	御嵩町
Mitane	三種町
Mito	水戸市
Mito	水戸
Mitoyo	三豊市
Mitsuke	見附市
Miura	三浦市
Miyake	三宅町
Miyaki	みやき町
Miyako	宮古市
Miyako	みやこ町
Miyakojima	宮古島市
Miyakonojō	都城市
Miyama	みやま市
Miyashiro	宮代町
Miyawaka	宮若市
Miyazaki	宮崎市
Miyazaki	宮崎
Miyazu	宮津市
Miyoshi	みよし市
Miyoshi	三次市
Miyoshi	三好市
Miyoshi	三芳町
Miyota	御代田町
Mizuho	瑞穂市
Mizuho	瑞穂町
Mizumaki	水巻町
Mizunami	瑞浪市
Mizusawa	水沢市
Mobara	茂原市
Mobara	茂原
Mogami	最上町
Moji	門司市
Monbetsu	紋別市
Mooka	真岡市
Mori	森町
Moriguchi	守口市
Morioka	盛岡市
Morioka	盛岡
Moriya	守谷市
Moriyama	守山市
Moroyama	毛呂山町
Moseushi	妹背牛町
Motegi	茂木町
Motobu	本部町
Motomiya	本宮市
Motosu	本巣市
Motoyama	本山町
Mugi	牟岐町
Mukawa	むかわ町
Mukō	向日市
Munakata	宗像市
Murakami	村上市
Murata	村田町
Murayama	村山市
Muroran	室蘭市
Muroran	室蘭
Muroto	室戸市
Musashimurayama	武蔵村山市
Musashino	武蔵野市
Mutsu	むつ市
Mutsuzawa	睦沢町
Myōkō	妙高市
Nabari	名張市
Nachikatsuura	那智勝浦町
Nagahama	長浜市
Nagai	長井市
Nagaizumi	長泉町
Nagakute	長久手市
Nagano	長野市
Nagano	長野
Naganohara	長野原町
Naganuma	長沼町
Nagaoka	長岡市
Nagaoka	長岡
Nagaokakyō	長岡京市
Nagara	長柄町
Nagareyama	流山市
Nagasaki	長崎市
Nagasaki	長崎
Nagashima	長島町
Nagasu	長洲町
Nagato	長門市
Nagatoro	長瀞町
Nagawa	長和町
Nagayo	長与町
Nagi	奈義町
Nagiso	南木曽町
Nago	名護市
Nagomi	和水町
Nagoya	名古屋市
Nagoya	名古屋
Naha	那覇市
Naha	那覇
Nahari	奈半利町
Naie	奈井江町
Naka	那珂市
Naka	那賀町
Nakadomari	中泊町
Nakafurano	中富良野町
Nakagawa	中川町
Nakagawa	那珂川町
Nakai	中井町
Nakama	中間市
Nakaminato	那珂湊市
Nakano	中野市
Nakano	中野区
Nakanojō	中之条町
Nakanoto	中能登町
Nakashibetsu	中標津町
Nakatane	中種子町
Nakatonbetsu	中頓別町
Nakatosa	中土佐町
Nakatsu	中津市
Nakatsugawa	中津川市
Nakayama	中山町
Nakoso	勿来市
Namegata	行方市
Namegawa	滑川町
Namerikawa	滑川市
Namie	浪江町
Nan'yō	南陽市
Nanae	七飯町
Nanao	七尾市
Nanbu	南部町
Nanjō	南城市
Nankan	南関町
Nankoku	南国市
Nanporo	南幌町
Nantan	南丹市
Nanto	南砺市
Naoshima	直島町
Nara	奈良市
Nara	奈良
Naraha	楢葉町
Narashino	習志野市
Narita	成田市
Narita	成田
Naruto	鳴門市
Nasu	那須
Nasu	那須町
Nasukarasuyama	那須烏山市
Nasushiobara	那須塩原市
Natori	名取市
Nayoro	名寄市
Naze	名瀬市
Nemuro	根室市
Nerima	練馬区
Neyagawa	寝屋川市
Nichinan	日南市
Nichinan	日南町
Nihonmatsu	二本松市
Niigata	新潟市
Niigata	新潟
Niihama	新居浜市
Niihama	新浜
Niikappu	新冠町
Niimi	新見市
Niiza	新座市
Nikaho	にかほ市
Niki	仁木町
Nikko	日光
Nikkō	日光市
Ninohe	二戸市
Ninomiya	二宮町
Nirasaki	韮崎市
Niseko	ニセコ
Niseko	ニセコ町
Nishiaizu	西会津町
Nishihara	西原町
Nishiizu	西伊豆町
Nishikatsura	西桂町
Nishikawa	西川町
Nishiki	錦町
Nishinomiya	西宮市
Nishinoomote	西之表市
Nishinoshima	西ノ島町
Nishio	西尾市
Nishitōkyō	西東京市
Nishiwaga	西和賀町
Nishiwaki	西脇市
Nisshin	日進市
Niyodogawa	仁淀川町
Nobeoka	延岡市
Nobeoka	延岡
Noboribetsu	登別市
Noboribetsu	登別
Noda	野田市
Nōgata	直方市
Nogi	野木町
Noheji	野辺地町
Nomi	能美市
Nonoichi	野々市市
Nose	能勢町
Noshiro	能代市
Noto	能登町
Numata	沼田市
Numata	沼田町
Numazu	沼津市
Numazu	沼津
Nyūzen	入善町
Oamishirasato	大網白里市
Ōarai	大洗町
Obama	小浜市
Obanazawa	尾花沢市
Obihiro	帯広市
Obihiro	帯広
Obira	小平町
Ōbu	大府市
Obuse	小布施町
Ochi	越知町
Ōda	大田市
Ōdai	大台町
Ōdate	大館市
Odawara	小田原市
Odawara	小田原
Ōe	大江町
Ōfunato	大船渡市
Oga	男鹿市
Ogaki	大垣
Ōgaki	大垣市
Ogano	小鹿野町
Ogawa	小川町
Ōgawara	大河原町
Ogi	小城市
Ogōri	小郡市
Ogose	越生町
Ōguchi	大口町
Oguni	小国町
Ōharu	大治町
Ōi	大井町
Ōi	おおい町
Oirase	おいらせ町
Ōishida	大石田町
Ōiso	大磯町
Oita	大分
Ōita	大分市
Ōizumi	大泉町
Ōji	王寺町
Ojika	小値賀町
Ojiya	小千谷市
Okagaki	岡垣町
Ōkawa	大川市
Okaya	岡谷市
Okayama	岡山市
Okayama	岡山
Okazaki	岡崎市
Okazaki	岡崎
Okegawa	桶川市
Oketo	置戸町
Ōki	大木町
Okinawa	沖縄市
Okinawa	沖縄
Okinoshima	隠岐の島町
Okoppe	興部町
Ōkuchi	大口市
Okuizumo	奥出雲町
Ōkuma	大熊町
Okushiri	奥尻町
Okutama	奥多摩町
Ōma	大間町
Ōmachi	大町市
Ōmachi	大町町
Omaezaki	御前崎市
Ōmagari	大曲市
Ōme	青梅市
Ōmihachiman	近江八幡市
Omitama	小美玉市
Omiya	大宮
Ōmu	雄武町
Ōmura	大村市
Ōmuta	大牟田市
Onagawa	女川町
Ōnan	邑南町
Onga	遠賀町
Onjuku	御宿町
Ono	小野市
Ono	小野町
Ōno	大野市
Ōno	大野町
Ōnojō	大野城市
Onomichi	尾道市
Ōra	邑楽町
Osaka	大阪市
Osaka	大阪
Ōsakasayama	大阪狭山市
Ōsaki	大崎市
Ōsaki	大崎町
Ōsakikamijima	大崎上島町
Ōsato	大郷町
Oshamambe	長万部町
Ōshima	大島町
Ōshū	奥州市
Ōta	太田市
Ōta	大田区
Ōtake	大竹市
Ōtaki	大多喜町
Otaru	小樽市
Otaru	小樽
Ōtawara	大田原市
Ōtō	大任町
Otobe	乙部町
Otofuke	音更町
Ōtoyo	大豊町
Ōtsu	大津市
Ōtsuchi	大槌町
Ōtsuki	大月市
Ōtsuki	大月町
Ōwani	大鰐町
Owariasahi	尾張旭市
Owase	尾鷲市
Oyabe	小矢部市
Oyama	小山市
Oyama	小山町
Ōyamazaki	大山崎町
Ōyodo	大淀町
Ōzora	大空町
Ōzu	大洲市
Ōzu	大津町
Pippu	比布町
Rankoshi	蘭越町
Ranzan	嵐山町
Rausu	羅臼町
Rebun	礼文町
Reihoku	苓北町
Rifu	利府町
Rikubetsu	陸別町
Rikuzentakata	陸前高田市
Rishiri	利尻町
Rishirifuji	利尻富士町
Rittō	栗東市
Rokunohe	六戸町
Rumoi	留萌市
Ryūgasaki	龍ヶ崎市
Ryūō	竜王町
Sabae	鯖江市
Sado	佐渡市
Saga	佐賀市
Saga	佐賀
Sagae	寒河江市
Sagamihara	相模原市
Saijō	西条市
Saikai	西海市
Saiki	佐伯市
Saitama	さいたま市
Saitama	埼玉
Saito	西都市
Saka	坂町
Sakado	坂戸市
Sakae	栄町
Sakahogi	坂祝町
Sakai	坂井市
Sakai	堺市
Sakai	堺
Sakai	境町
Sakaide	坂出市
Sakaiminato	境港市
Sakaki	坂城町
Sakata	酒田市
Sakawa	佐川町
Saku	佐久市
Sakuho	佐久穂町
Sakura	佐倉市
Sakura	さくら市
Sakuragawa	桜川市
Sakurai	桜井市
Samani	様似町
Samukawa	寒川町
San'yō-Onoda	山陽小野田市
Sanda	三田市
Sangō	三郷町
Sanjō	三条市
Sanmu	山武市
Sannohe	三戸町
Sano	佐野市
Sanuki	さぬき市
Sapporo	札幌市
Sapporo	札幌
Saroma	佐呂間町
Sasaguri	篠栗町
Sasayama	篠山市
Sasebo	佐世保市
Sasebo	佐世保
Satoshō	里庄町
Satsuma	さつま町
Satsumasendai	薩摩川内市
Satte	幸手市
Sawara	佐原市
Sayama	狭山市
Sayō	佐用町
Saza	佐々町
Seika	精華町
Seirō	聖籠町
Seiyo	西予市
Seki	関市
Sekigahara	関ケ原町
Semboku	仙北市
Sendai	仙台市
Sendai	仙台
Sendai	川内市
Sennan	泉南市
Sera	世羅町
Setagaya	世田谷区
Setana	せたな町
Seto	瀬戸市
Seto	瀬戸
Setouchi	瀬戸内市
Setouchi	瀬戸内町
Settsu	摂津市
Shakotan	積丹町
Shari	斜里町
Shibata	新発田市
Shibata	柴田町
Shibayama	芝山町
Shibecha	標茶町
Shibetsu	士別市
Shibetsu	標津町
Shibukawa	渋川市
Shibushi	志布志市
Shibuya	渋谷区
Shichigahama	七ヶ浜町
Shichikashuku	七ヶ宿町
Shichinohe	七戸町
Shihoro	士幌町
Shijōnawate	四條畷市
Shika	志賀町
Shikabe	鹿部町
Shikama	色麻町
Shikaoi	鹿追町
Shiki	志木市
Shikokuchūō	四国中央市
Shima	志摩市
Shimabara	島原市
Shimada	島田市
Shimamoto	島本町
Shimanto	四万十市
Shimanto	四万十町
Shime	志免町
Shimizu	清水
Shimizu	清水町
Shimoda	下田市
Shimodate	下館市
Shimogō	下郷町
Shimoichi	下市町
Shimokawa	下川町
Shimonita	下仁田町
Shimonoseki	下関市
Shimonoseki	下関
Shimosuwa	下諏訪町
Shimotsuke	下野市
Shimotsuma	下妻市
Shin'onsen	新温泉町
Shinagawa	品川区
Shinano	信濃町
Shinchi	新地町
Shingū	新宮市
Shingū	新宮町
Shinhidaka	新ひだか町
Shinjō	新庄市
Shinjuku	新宿区
Shinkamigotō	新上五島町
Shinshiro	新城市
Shintoku	新得町
Shintomi	新富町
Shintotsukawa	新十津川町
Shiogama	塩竈市
Shiojiri	塩尻市
Shioya	塩谷町
Shirahama	白浜町
Shirakawa	白河市
Shirakawa	白川町
Shirako	白子町
Shiranuka	白糠町
Shiraoi	白老町
Shiraoka	白岡市
Shirataka	白鷹町
Shiriuchi	知内町
Shiroi	白井市
Shiroishi	白石市
Shiroishi	白石町
Shirosato	城里町
Shisō	宍粟市
Shisui	酒々井町
Shitara	設楽町
Shiwa	紫波町
Shizukuishi	雫石町
Shizuoka	静岡市
Shizuoka	静岡
Shōbara	庄原市
Shōdoshima	小豆島町
Shōnai	庄内町
Shōō	勝央町
Shōwa	昭和町
Shūnan	周南市
Sōbetsu	壮瞥町
Sodegaura	袖ヶ浦市
Soeda	添田町
Sōja	総社市
Sōka	草加市
Sōma	相馬市
Soo	曽於市
Sōsa	匝瑳市
Sotogahama	外ヶ浜町
Special wards of Tokyo	東京特別区部
Sue	須恵町
Suginami	杉並区
Sugito	杉戸町
Suita	吹田市
Sukagawa	須賀川市
Sukumo	宿毛市
Sumida	墨田区
Sumita	住田町
Sumoto	洲本市
Sunagawa	砂川市
Suōōshima	周防大島町
Susaki	須崎市
Susami	すさみ町
Susono	裾野市
Suttsu	寿都町
Suwa	諏訪市
Suzaka	須坂市
Suzu	珠洲市
Suzuka	鈴鹿市
Suzuka	鈴鹿
Tabuse	田布施町
Tachiarai	大刀洗町
Tachikawa	立川市
Tachikawa	立川
Tadami	只見町
Tadaoka	忠岡町
Tadotsu	多度津町
Taga	多賀町
Tagajō	多賀城市
Tagami	田上町
Tagawa	田川市
Tahara	田原市
Taiji	太地町
Taiki	大樹町
Taiki	大紀町
Tainai	胎内市
Taira	平市
Taishi	太子町
Taitō	台東区
Taiwa	大和町
Tajimi	多治見市
Tajiri	田尻町
Taka	多可町
Takachiho	高千穂町
Takahagi	高萩市
Takahama	高浜市
Takahama	高浜町
Takaharu	高原町
Takahashi	高梁市
Takahata	高畠町
Takaishi	高石市
Takamatsu	高松市
Takamatsu	高松
Takamori	高森町
Takanabe	高鍋町
Takanezawa	高根沢町
Takaoka	高岡市
Takaoka	高岡
Takarazuka	宝塚市
Takarazuka	宝塚
Takasago	高砂市
Takasaki	高崎市
Takasaki	高崎
Takashima	高島市
Takasu	鷹栖町
Takatori	高取町
Takatsuki	高槻市
Takatsuki	高槻
Takayama	高山市
Takayama	高山
Takefu	武生市
Takehara	竹原市
Takeo	武雄市
Taketa	竹田市
Taketomi	竹富町
Taketoyo, Mihama	武豊町
Taki	多気町
Takikawa	滝川市
Takinoue	滝上町
Takizawa	滝沢市
Takko	田子町
Tako	多古町
Taku	多久市
Tama	多摩市
Tamaki	玉城町
Tamamura	玉村町
Tamana	玉名市
Tamano	玉野市
Tamba	丹波市
Tamura	田村市
Tanabe	田辺市
Tanagura	棚倉町
Tanashi	田無市
Taniyama	谷山市
Tano	田野町
Tara	太良町
Taragi	多良木町
Tarui	垂井町
Tarumizu	垂水市
Tatebayashi	館林市
Tateshina	立科町
Tateshina-Kogen	蓼科高原
Tateyama	館山市
Tateyama	立山町
Tatsugō	龍郷町
Tatsuno	たつの市
Tatsuno	辰野町
Tatsuno	龍野市
Tawaramoto	田原本町
Tendō	天童市
Tenri	天理市
Teshikaga	弟子屈町
Teshio	天塩町
Toba	鳥羽市
Toba	鳥羽
Tobata	戸畑市
Tobe	砥部町
Tōbetsu	当別町
Tochigi	栃木市
Toda	戸田市
Tōei	東栄町
Tōgane	東金市
Togitsu	時津町
Tōgō	東郷町
Tōhoku	東北町
Tōin	東員町
Tōkai	東海市
Tōkamachi	十日町市
Toki	土岐市
Tokigawa	ときがわ町
Tokoname	常滑市
Tokorozawa	所沢市
Tokunoshima	徳之島町
Tokushima	徳島市
Tokushima	徳島
Tokyo	東京
Tokyo	東京市
Tōma	当麻町
Tomakomai	苫小牧市
Tomamae	苫前町
Tome	登米市
Tōmi	東御市
Tomigusuku	豊見城市
Tomika	富加町
Tomioka	富岡市
Tomioka	富岡町
Tomisato	富里市
Tomiya	富谷市
Tonami	砺波市
Tondabayashi	富田林市
Tone	利根町
Tōno	遠野市
Tonoshō	土庄町
Tōnoshō	東庄町
Tōon	東温市
Toride	取手市
Tosa	土佐市
Tosa	土佐町
Tosashimizu	土佐清水市
Toshima	豊島区
Tosu	鳥栖市
Tottori	鳥取市
Tottori	鳥取
Towada	十和田市
Towada	十和田
Tōyako	洞爺湖町
Toyama	富山市
Toyama	富山
Tōyo	東予市
Tōyō	東洋町
Toyoake	豊明市
Toyohara	豊原市
Toyohashi	豊橋市
Toyohashi	豊橋
Toyokawa	豊川市
Toyokoro	豊頃町
Toyonaka	豊中市
Toyono	豊能町
Toyooka	豊岡市
Toyosato	豊郷町
Toyota	豊田市
Toyota	豊田
Toyotomi	豊富町
Toyoura	豊浦町
Toyoyama	豊山町
Tsu	津市
Tsu	津
Tsubame	燕市
Tsubata	津幡町
Tsubetsu	津別町
Tsuchiura	土浦市
Tsugaru	つがる市
Tsukigata	月形町
Tsukuba	つくば市
Tsukubamirai	つくばみらい市
Tsukumi	津久見市
Tsunagi	津奈木町
Tsunan	津南町
Tsuno	津野町
Tsuno	都農町
Tsuru	都留市
Tsuruga	敦賀市
Tsurugashima	鶴ヶ島市
Tsurugi	つるぎ町
Tsuruoka	鶴岡市
Tsuruta	鶴田町
Tsushima	津島市
Tsushima	対馬市
Tsuwano	津和野町
Tsuyama	津山市
Ube	宇部市
Ube	宇部
Uchigō	内郷市
Uchiko	内子町
Uchinada	内灘町
Uda	宇陀市
Ueda	上田市
Uenohara	上野原市
Ugo	羽後町
Uji	宇治市
Uji	宇治
Ujitawara	宇治田原町
Uki	宇城市
Ukiha	うきは市
Umi	宇美町
Unnan	雲南市
Unzen	雲仙市
Unzen	雲仙
Uonuma	魚沼市
Uozu	魚津市
Urahoro	浦幌町
Urakawa	浦河町
Urasoe	浦添市
Urasoe	浦添
Urausu	浦臼町
Urawa	浦和
Urayasu	浦安市
Ureshino	嬉野市
Uruma	うるま市
Uryū	雨竜町
Usa	宇佐市
Ushiku	牛久市
Usuki	臼杵市
Utashinai	歌志内市
Utazu	宇多津町
Uto	宇土市
Utsunomiya	宇都宮市
Utsunomiya	宇都宮
Uwajima	宇和島市
Wadomari	和泊町
Wajima	輪島市
Wakamatsu	若松市
Wakasa	若狭町
Wakasa	若桜町
Wakayama	和歌山市
Wakayama	和歌山
Wake	和気町
Waki	和木町
Wakkanai	稚内市
Wakkanai	稚内
Wakō	和光市
Wakuya	涌谷町
Wanouchi	輪之内町
Warabi	蕨市
Wassamu	和寒町
Watarai	度会町
Watari	亘理町
Wazuka	和束町
Yabu	養父市
Yabuki	矢吹町
Yachimata	八街市
Yachiyo	八千代市
Yachiyo	八千代町
Yaese	八重瀬町
Yahaba	矢巾町
Yahata	八幡市
Yaita	矢板市
Yaizu	焼津市
Yakage	矢掛町
Yakumo	八雲町
Yakushima	屋久島
Yakushima	屋久島町
Yamada	山田町
Yamada	山田市
Yamaga	山鹿市
Yamagata	山県市
Yamagata	山形市
Yamagata	山形
Yamaguchi	山口市
Yamaguchi	山口
Yamakita	山北町
Yamamoto	山元町
Yamanashi	山梨市
Yamanobe	山辺町
Yamanouchi	山ノ内町
Yamato	大和市
Yamato	山都町
Yamatokōriyama	大和郡山市
Yamatotakada	大和高田市
Yamatsuri	矢祭町
Yame	八女市
Yanagawa	柳川市
Yanai	柳井市
Yanaizu	柳津町
Yao	八尾市
Yao	八尾
Yaotsu	八百津町
Yashio	八潮市
Yasu	野洲市
Yasuda	安田町
Yasugi	安来市
Yatomi	弥富市
Yatsushiro	八代市
Yawata	八幡市
Yawatahama	八幡浜市
Yazu	八頭町
Yoichi	余市町
Yōkaichiba	八日市場市
Yokkaichi	四日市市
Yokkaichi	四日市
Yokohama	横浜市
Yokohama	横浜
Yokohama	横浜町
Yokoshibahikari	横芝光町
Yokosuka	横須賀市
Yokosuka	横須賀
Yokote	横手市
Yokoze	横瀬町
Yonabaru	与那原町
Yonago	米子市
Yonago	米子
Yonaguni	与那国町
Yonezawa	米沢市
Yorii	寄居町
Yōrō	養老町
Yoron	与論町
Yosano	与謝野町
Yoshida	吉田町
Yoshika	吉賀町
Yoshikawa	吉川市
Yoshimi	吉見町
Yoshino	吉野町
Yoshinogari	吉野ヶ里町
Yoshinogawa	吉野川市
Yoshioka	吉岡町
Yoshitomi	吉富町
Yotsukaidō	四街道市
Yuasa	湯浅町
Yūbari	夕張市
Yūbetsu	湧別町
Yufu	由布市
Yugawara	湯河原町
Yūki	結城市
Yukuhashi	行橋市
Yuni	由仁町
Yunohira	湯平
Yunomae	湯前町
Yura	由良町
Yurihama	湯梨浜町
Yurihonjō	由利本荘市
Yusuhara	梼原町
Yūsui	湧水町
Yuza	遊佐町
Yuzawa	湯沢市
Yuzawa	湯沢
Yuzawa	湯沢町
Zama	座間市
Zaō	蔵王町
Zentsūji	善通寺市
Zushi	逗子市
Zushi	逗子